111111111111111111111111111111111
10000C000000000000000000010000001
100000000000000000000000C00000001
1C01100P0000000000C00000010000001
1000E1111100000000000000000011001
10000000000000000000C000000011001
111111111111000011111111110000001
10000000000000000000C000000000001
100000000001110110111111111111111
100000000000000000000000001000001
100000000000000000000000000000001
111111111111111111111111111111111