11111111111
1100P00P001
10C00000001
100000E0001
11111111111