11111111111111111111111111
10000C00000000000000000001
10000000000000000000000001
1C011000000000000000000001
1000E111110000000000000001
10000000000000000000C00001
11111111111100001111111111
11111111111111111111111111