1111111111
10000P0001
1E00000001
10000000C1
10000C0001
10000000
1000000001
1000000001
1000000001
1111110111
1000000001
1000000001
1111011111
10000C0001
1111111111