11111111
100C0001
10000P01
100E0001
11111111